###########
#     # # #
### # # # #
# # # #   #
# ### ### #
#  #      #
# ### # # #
# #   # # #
# # # ### #
#   # #   #
###########