###########
#     #   #
### # # # #
# # #     #
# ### ### #
# #       #
# ### # # #
# #   # # #
# # # ### #
# # # #   #
###########