#############################################################
# #   #           #                   #         #     #     #
# # # # ##### ##### ############# # ### ### ### # # # ### # #
# # #   #   # #         #       # #     #   #   #   #   # # #
# # ##### # # # ######### ##### # ####### ####### # ### ### #
# #     # # # # #   #     #   # #   #   #       # # #       #
# ##### # ### # ### # ##### # # ### ### ####### # # ### # # #
#         #   #   #   #     # #   #         # #   #   #   # #
# ######### ##### # # # ##### ### ######### # ##### # ##### #
# # #     #         #     #   #   #     #     #   # # #     #
# # # ### ########### ##### # # ### ### ##### # # ### ### # #
#   #             #   #     # #   # # #   #   # #   #     # #
### # ##### ##### # ### ######### # # ### ##### ### # ### ###
# # #   #   #       #                   # #     # # #   #   #
# # ### # # # ##### # ################# # # ##### # # ##### #
#     #   # # #     #     #     # #   # # # #   #   # #   # #
######### # # # # # ##### # # # # # ### # # # # # ##### # # #
#   #     # # # # # #   #   #       #       #   #   #   #   #
# # # # ### # # # ### # ######### # ######### # ### # ##### #
# # # #   # # # # #   #     #   # #         # #   #   #   # #
# # # ### # # ### # ####### # # # ######### # ######### # # #
# #   # #   #     # #     #   # #   #   #   #     #     # # #
# ##### ### ####### ### # ##### ### ### # ####### # ### ### #
# #     #   #     # #   #     # #     # #       #     #     #
# # ### # ### ### # # ####### # # ### # ####### ##### # # ###
# #   #   #   #   #   #     #   #   #   #   # # #       #   #
# ### ##### ### # ##### ### # # ### ### # # # # # ##### #####
#   # #     # # #     #   # # #   #       #   #   #   #     #
# # ### ##### # ####### # ### ### ################# ####### #
# #           #         #       #                           #
#############################################################